BOMBERMAN_LEVEL
1.0
12 10
5 4 4 4 4 4 4 4 4 4 4 5 
5 1 1 1 1 1 1 1 1 1 1 5  
5 0 3 5 5 5 3 3 3 3 0 5 
5 0 3 5 3 5 3 3 3 3 0 5 
5 0 3 5 5 5 3 5 3 3 0 5 
5 0 3 5 3 3 3 3 3 3 0 5 
5 0 3 5 3 3 3 5 3 3 0 5 
5 0 2 4 2 2 2 4 2 2 0 5 
5 0 1 1 1 1 1 1 1 1 0 5 
5 5 5 5 5 5 5 5 5 5 5 5 
